====================
====================
====#####===========
====#---#===========
====#$--#===========
==###--$##==========
==#--$-$-#==========
###-#-##-#===######=
#---#-##-#####--..#=
#-$--$----------..#=
#####-###-#@##--..#=
====#-----#########=
====#######=========
====================
====================